02 02 02 02 02 02 02 02 02 02 02 02 02 02 02 02 02 02 02 02 02 02 02 02 02 02 02 02 02 02 02 02 02 02 02 02 02 02 02 02 02 02 02 02 02 02 02 02 02 02
02 02 02 02 02 02 02 02 02 02 02 02 02 02 02 02 02 02 02 02 02 02 02 02 02 02 02 02 02 02 02 02 02 02 02 02 02 02 02 02 02 02 02 02 02 02 02 02 02 02
02 02 02 02 02 02 02 02 02 02 02 02 02 02 02 02 02 02 02 02 02 02 02 02 02 02 02 02 02 02 02 02 02 02 02 02 02 02 02 02 02 02 02 02 02 02 02 02 02 02
02 02 02 02 02 02 02 02 02 02 02 02 02 02 02 02 02 02 02 02 02 02 02 02 02 02 02 02 02 02 02 02 02 02 02 02 02 02 02 02 02 02 02 02 02 02 02 02 02 02
02 02 02 02 02 02 02 02 02 02 02 02 02 02 02 02 02 02 02 02 02 02 02 02 02 02 02 02 02 02 02 02 02 02 02 02 02 02 02 02 02 02 02 02 02 02 02 02 02 02
02 02 02 02 02 02 02 02 02 02 02 02 02 02 02 02 02 02 02 02 02 02 02 02 02 02 02 02 02 02 02 02 02 02 02 02 02 02 02 02 02 02 02 02 02 02 02 02 02 02
02 02 02 02 02 02 02 02 02 02 02 02 02 02 02 02 02 02 02 02 02 02 02 02 02 02 02 02 02 02 02 02 02 02 02 02 02 02 02 02 02 02 02 02 02 02 02 02 02 02
02 02 02 02 02 02 02 02 02 02 02 02 02 02 02 02 02 02 00 00 00 02 02 02 02 02 02 02 02 02 02 02 02 02 02 02 02 02 02 02 02 02 02 02 02 02 02 02 02 02
02 02 02 02 02 02 02 02 02 02 02 02 02 02 02 02 02 02 00 00 00 02 02 02 02 02 02 02 02 02 02 02 02 02 02 02 02 02 02 02 02 02 02 02 02 02 02 02 02 02
02 02 02 02 02 02 02 02 02 02 02 02 02 02 02 02 02 02 00 00 00 02 02 02 02 02 02 02 02 02 02 02 02 02 02 02 02 02 02 02 02 02 02 02 02 02 02 02 02 02
02 02 02 02 02 02 02 02 02 02 02 02 02 02 02 02 02 02 00 00 00 02 02 02 02 02 02 02 02 02 02 02 02 02 02 02 02 02 02 02 02 02 02 02 02 02 02 02 02 02
02 02 02 02 02 02 02 02 02 02 02 02 02 02 02 02 02 02 02 00 00 00 02 02 02 02 02 02 02 02 02 02 02 02 02 02 02 02 02 02 02 02 02 02 02 02 02 02 02 02
02 02 02 02 02 02 02 02 02 11 11 11 11 11 11 11 11 11 11 11 11 11 11 11 11 11 11 11 11 11 11 11 11 11 11 11 11 11 11 11 02 02 02 02 02 02 02 02 02 02
02 02 02 02 02 02 02 02 02 11 00 00 00 00 00 00 00 00 13 01 01 01 13 00 00 00 00 00 00 00 00 00 00 00 00 00 00 00 00 11 02 02 02 02 02 02 02 02 02 02
02 02 02 02 02 02 02 02 02 11 00 00 02 00 02 00 00 00 13 01 01 01 13 00 00 00 00 00 00 00 00 02 00 00 02 00 00 00 00 11 02 02 02 02 02 02 02 02 02 02
02 02 02 02 02 02 02 02 02 11 00 00 02 00 02 00 00 00 13 01 01 01 13 00 00 00 00 00 00 00 00 02 00 00 02 00 00 00 00 11 02 02 02 02 02 02 02 02 02 02
02 02 02 02 02 02 02 02 02 11 00 00 02 00 02 00 00 00 13 01 01 01 13 00 00 00 00 00 00 00 00 02 00 00 02 00 00 00 00 11 02 02 02 02 02 02 02 02 02 02
02 02 02 02 02 02 02 02 02 11 00 00 02 00 02 00 00 00 13 01 01 01 13 00 00 00 00 00 00 00 00 02 00 00 02 00 00 00 00 11 02 02 02 02 02 02 02 02 02 02
02 02 02 02 02 02 02 02 02 11 00 00 00 00 00 00 00 00 13 01 01 01 13 00 00 00 00 00 00 00 00 00 00 00 00 00 00 00 00 11 02 02 02 02 02 02 02 02 02 02
02 02 02 02 02 02 02 02 02 11 00 00 00 00 00 00 00 00 13 01 01 01 13 00 00 00 00 00 00 00 00 00 00 00 00 00 00 00 00 11 02 02 02 02 02 02 02 02 02 02
02 02 02 02 02 02 02 02 02 11 00 00 00 00 00 00 00 00 00 13 01 01 01 13 00 00 00 00 00 00 00 00 00 00 00 00 00 00 00 11 02 02 02 02 02 02 02 02 02 02
02 02 02 02 02 02 02 02 02 11 00 00 00 00 00 00 00 00 00 13 01 01 01 13 00 00 00 00 00 00 00 00 00 00 00 00 00 00 00 11 02 02 02 02 02 02 02 02 02 02
02 02 02 02 02 02 02 02 02 11 00 00 02 00 02 00 00 00 00 00 13 01 01 01 13 00 00 00 00 00 00 02 00 00 02 00 00 00 00 11 02 02 02 02 02 02 02 02 02 02
02 02 02 02 02 02 02 02 02 11 00 00 02 00 02 00 00 00 00 00 13 01 01 01 13 00 00 00 00 00 00 02 00 00 02 00 00 00 00 11 02 02 02 02 02 02 02 02 02 02
02 02 02 02 02 02 02 02 02 11 00 00 02 00 02 00 00 00 00 00 00 13 01 01 01 13 00 00 00 00 00 02 00 00 02 00 00 00 00 11 02 02 02 02 02 02 02 02 02 02
02 02 02 02 02 02 02 02 02 11 00 00 02 00 02 00 00 00 00 00 00 00 13 01 01 01 13 00 00 00 00 02 00 00 02 00 00 00 00 11 02 02 02 02 02 02 02 02 02 02
02 02 02 02 02 02 02 02 02 11 00 00 00 00 00 00 00 00 00 00 00 00 00 01 01 01 00 00 00 00 00 00 00 00 00 00 00 00 00 11 02 02 02 02 02 02 02 02 02 02
02 02 02 02 02 02 02 02 02 11 00 00 00 00 00 00 00 00 00 00 00 00 00 01 01 01 00 00 00 00 00 00 00 00 00 00 00 00 00 11 02 02 02 02 02 02 02 02 02 02
02 02 02 02 02 02 02 02 02 11 00 00 00 00 00 00 10 10 10 10 10 10 10 10 09 10 10 10 10 10 10 10 10 00 00 00 00 00 00 11 02 02 02 02 02 02 02 02 02 02
02 02 02 02 02 02 02 02 02 11 00 00 00 00 00 00 10 05 05 05 05 05 05 05 05 05 05 05 05 05 05 05 10 00 00 00 00 00 00 11 02 02 02 02 02 02 02 02 02 02
02 02 02 02 02 02 02 02 02 11 00 00 00 00 00 00 10 05 05 05 05 05 12 05 05 05 05 05 05 05 05 05 10 00 00 00 00 00 00 11 02 02 02 02 02 02 02 02 02 02
02 02 02 02 02 02 02 02 02 11 00 00 00 00 00 00 10 05 05 05 04 04 04 04 03 04 04 04 04 05 05 05 10 00 00 00 00 00 00 11 02 02 02 02 02 02 02 02 02 02
02 02 02 02 02 02 02 02 02 11 00 00 02 02 00 00 10 05 05 05 04 04 04 04 04 04 04 04 04 05 05 05 10 00 00 02 02 00 00 11 02 02 02 02 02 02 02 02 02 02
02 02 02 02 02 02 02 02 02 11 00 00 02 02 00 00 10 05 05 06 06 06 06 06 07 08 08 08 08 08 05 05 10 00 00 02 02 00 00 11 02 02 02 02 02 02 02 02 02 02
02 02 02 02 02 02 02 02 02 11 00 00 02 02 00 00 10 05 05 06 06 06 06 06 07 08 08 08 08 08 05 05 10 00 00 02 02 00 00 11 02 02 02 02 02 02 02 02 02 02
02 02 02 02 02 02 02 02 02 11 00 00 02 02 00 00 10 05 05 06 06 06 06 06 07 08 08 08 08 08 05 05 10 00 00 02 02 00 00 11 02 02 02 02 02 02 02 02 02 02
02 02 02 02 02 02 02 02 02 11 00 00 00 00 00 00 10 05 05 06 06 06 06 06 07 08 08 08 08 08 05 05 10 00 00 00 00 00 00 11 02 02 02 02 02 02 02 02 02 02
02 02 02 02 02 02 02 02 02 11 00 00 00 00 00 00 10 05 05 06 06 06 06 06 07 08 08 08 08 08 05 05 10 00 00 00 00 00 00 11 02 02 02 02 02 02 02 02 02 02
02 02 02 02 02 02 02 02 02 11 00 00 00 00 00 00 10 05 05 06 06 06 06 06 07 08 08 08 08 08 05 05 10 00 00 00 00 00 00 11 02 02 02 02 02 02 02 02 02 02
02 02 02 02 02 02 02 02 02 11 00 00 00 00 00 00 10 05 05 06 06 06 06 06 07 08 08 08 08 08 05 05 10 00 00 00 00 00 00 11 02 02 02 02 02 02 02 02 02 02
02 02 02 02 02 02 02 02 02 11 11 11 11 11 11 11 10 10 10 06 06 06 06 06 07 08 08 08 08 08 10 10 10 11 11 11 11 11 11 11 02 02 02 02 02 02 02 02 02 02
02 02 02 02 02 02 02 02 02 11 00 00 00 00 00 00 10 05 05 06 06 06 06 06 07 08 08 08 08 08 05 05 10 00 00 00 00 00 00 11 02 02 02 02 02 02 02 02 02 02
02 02 02 02 02 02 02 02 02 11 00 00 00 00 00 00 10 05 05 06 06 06 06 06 07 08 08 08 08 08 05 05 10 00 00 00 00 00 00 11 02 02 02 02 02 02 02 02 02 02
02 02 02 02 02 02 02 02 02 11 00 00 00 00 00 00 10 05 05 06 06 06 06 06 07 08 08 08 08 08 05 05 10 00 00 00 00 00 00 11 02 02 02 02 02 02 02 02 02 02
02 02 02 02 02 02 02 02 02 11 00 00 00 00 00 00 10 05 05 06 06 06 06 06 07 08 08 08 08 08 05 05 10 00 00 00 00 00 00 11 02 02 02 02 02 02 02 02 02 02
02 02 02 02 02 02 02 02 02 11 00 00 02 02 02 02 02 02 02 02 02 02 02 02 02 02 02 02 02 02 02 02 02 02 02 02 02 00 00 11 02 02 02 02 02 02 02 02 02 02
02 02 02 02 02 02 02 02 02 11 00 00 02 02 02 02 02 02 02 02 02 02 02 02 02 02 02 02 02 02 02 02 02 02 02 02 02 00 00 11 02 02 02 02 02 02 02 02 02 02
02 02 02 02 02 02 02 02 02 11 00 00 02 02 02 02 02 02 02 02 02 02 02 02 02 02 02 02 02 02 02 02 02 02 02 02 02 00 00 11 02 02 02 02 02 02 02 02 02 02
02 02 02 02 02 02 02 02 02 11 00 00 02 02 02 02 02 02 02 02 02 02 02 02 02 02 02 02 02 02 02 02 02 02 02 02 02 00 00 11 02 02 02 02 02 02 02 02 02 02
02 02 02 02 02 02 02 02 02 11 00 00 02 02 02 02 02 02 02 02 02 02 02 02 02 02 02 02 02 02 02 02 02 02 02 02 02 00 00 11 02 02 02 02 02 02 02 02 02 02